 #########
##   #   ##
#    #    #
#  $ # $  #
#   *.*   #
####.@.####
#   *.*   #
#  $ # $  #
#    #    #
##   #   ##
 #########

; 144

   ####
 ###  #####
 # $$ #   #
 # $ . .$$##
 # .. #. $ #
### #** .  #
#  . **# ###
# $ .# .. #
##$$.@. $ #
 #   # $$ #
 #####  ###
     ####

; 153
'reduction of (Revenge 306)'

#############
#.# @#  #   #
#.#$$   # $ #
#.#  # $#   #
#.# $#  # $##
#.#  # $#  #
#.# $#  # $#
#..  # $   #
#..  #  #  #
############

